🧱🧱🧱🧱🧱🧱🧱🧱🧱🧱🧱🧱🧱🧱🧱🧱🧱🧱🧱🧱
🧱💡🔳🧱🧱🔳🗝️🧱🔳🗝️🔳🔳🔳🔳🧱🔳🔳🔳🔳🧱
🧱🔳🔳🤖🔳🔳🧱🧱🔳🔳🔳🔳🔳🔳🧱🔳💎🔳🔳🧱
🧱🧱🧱🧱🔏🧱🧱🧱🔳🔳🔳🔳🔳🔳🧱🧱🧱🧱🔏🧱
🧱🔳🔳🔳🔳🔳🔳🔳🔳🔳🔳🔳🔳🔳🔳🔳🔳🔳🔳🧱
🧱🔳💎🔳🔳🔳🔳🔳🔳🔳🔳🔳🔳🔳🔳🔳🔳🔳🔳🧱
🧱🔳🔳🔳🔳🔳🔳🧱🧱🧱🧱🔳🔳🔳🔳🔑🔳🔳🔳🧱
🧱🔳🔳🔳🔳🔳🔳🔳🔳🧱🧱🔳🔳🔳🔳🔳🔳🔳🔳🧱
🧱🔳🔳🔳🔳🔳🔳🔳🔳🧱🧱🔳🔳🔳🔳🔳🔳🔳🔳🧱
🧱🔳🧱🔳🔳🔳🔳🔳🔳🧱🧱🔳🔳🔳🔳🔳🔳🔳🔳🧱
🧱🔑🧱🔳🔳🔳🔳🔳🔳🔳🔳🔳🔳🔳🔳🔳🔳🔳🔳🧱
🧱🧱🧱🧱🧱🧱🧱🔳🔳🔳🔳🔳🧱🧱🧱🧱🔳🔳🔳🧱
🧱🧱🧱🧱💎🧱🧱🔳🔳🔳🔳🔳🧱🔳🔳🧱🔳🔳🔳🧱
🧱🧱🧱🧱🔳🧱🧱🔳🔳🔳🔳🔳🧱🧱🧱🧱🔳🔳🔳🧱
🧱🧱🧱🧱🔒🧱🧱🔳🔳🔳🔳🔳🔳🔳🔳🔳🔳🔳🔳🧱
🧱🔳🔳🔳🔳🔳🔳🔳🔳🔳🔳🔳🔳🔳🔳🔳🧱🔒🧱🧱
🧱🔳🔳🔳🔳🔳🔳🔳🔳🔳🔳🔳🔳🔳🔳🔳🧱💎🔳🧱
🧱🧱🧱🧱🧱🧱🧱🧱🧱🧱🧱🧱🧱🔳🔳🔳🧱🧱🧱🧱
🧱🚩🈲🔳🔳🔳🔳🔳🔳🔳🔳🔳🔳🔳🔳🔳🔳🔳🔳🧱
🧱🧱🧱🧱🧱🧱🧱🧱🧱🧱🧱🧱🧱🧱🧱🧱🧱🧱🧱🧱